82,82,82,82,82,82,82,82,00,10,10,10,10,10,10,10,10,10,10,10,10,10,10,10,20
82,82,82,82,82,82,82,82,01,11,11,11,11,11,11,11,11,11,11,11,11,11,11,11,21
82,82,82,82,82,82,82,82,01,11,11,11,11,11,11,11,11,11,11,11,11,11,11,11,21
82,82,82,82,82,82,82,82,01,11,11,11,11,11,11,11,11,11,11,11,11,11,11,11,21
82,82,82,82,82,82,82,82,01,11,11,11,11,11,11,11,11,11,11,11,11,11,11,11,21
82,82,82,82,82,82,82,82,01,11,11,11,11,11,11,11,11,11,11,11,11,11,11,11,21
82,82,82,82,82,82,82,82,01,11,11,11,11,11,11,11,11,11,11,11,11,11,11,11,21
82,82,82,82,82,82,82,82,01,11,11,11,11,11,11,11,11,11,11,11,11,11,11,11,21
82,82,82,82,82,82,82,82,01,11,11,11,11,11,11,11,11,11,11,11,11,11,11,11,21
82,82,82,82,82,82,82,82,01,11,11,11,11,11,11,11,11,11,11,11,11,11,11,11,21
82,82,82,82,82,82,82,82,01,11,11,11,11,11,11,11,11,11,11,11,11,11,11,11,21
82,82,82,82,82,82,82,82,01,11,11,11,11,11,11,11,11,11,11,11,11,11,11,11,21
82,82,82,82,82,82,82,82,01,11,11,11,11,11,11,11,11,11,11,11,11,11,11,11,21
82,82,82,82,82,82,82,82,01,11,11,11,11,11,11,11,11,11,11,11,11,11,11,11,21
82,82,82,82,82,82,82,82,01,11,11,11,11,11,11,11,11,11,11,11,11,11,11,11,21
82,82,82,82,82,82,82,82,01,11,11,11,11,11,11,11,11,11,11,11,11,11,11,11,21
82,82,82,82,82,82,82,82,01,11,11,11,11,11,11,11,11,11,11,11,11,11,11,11,21
82,82,82,82,82,82,82,82,01,11,11,11,11,11,11,11,11,11,11,11,11,11,11,11,21
82,82,82,82,82,82,82,82,01,11,11,11,11,11,11,11,11,11,11,11,11,11,11,11,21
82,82,82,82,82,82,82,82,01,11,11,11,11,11,11,11,11,11,11,11,11,11,11,11,21
82,82,82,82,82,82,82,82,01,11,11,11,11,11,11,11,11,11,11,11,11,11,11,11,21
82,82,82,82,82,82,82,82,01,11,11,11,11,11,11,11,11,11,11,11,11,11,11,11,21
82,82,82,82,82,82,82,82,01,11,11,11,11,11,11,11,11,11,11,11,11,11,11,11,21
82,82,82,82,82,82,82,82,01,11,11,11,11,11,11,11,11,11,11,11,11,11,11,11,21
82,82,82,82,82,82,82,82,01,11,11,11,11,11,11,11,11,11,11,11,11,11,11,11,21
82,82,82,82,82,82,82,82,01,11,11,11,11,11,11,11,11,11,11,11,11,11,11,11,21
82,82,82,82,82,82,82,82,01,11,11,11,11,11,11,11,11,11,11,11,11,11,11,11,21
82,82,82,82,82,82,82,82,01,11,11,11,11,11,11,11,11,11,11,11,11,11,11,11,21
82,82,82,82,82,82,82,82,01,11,11,11,11,11,11,11,11,11,11,11,11,11,11,11,21
82,82,82,82,82,82,82,82,02,12,12,12,12,12,12,12,12,12,12,12,12,12,12,12,22