82,21,21,21,21,21,21,21,21,21,21,21,21,21,21,21,21,21,21,21,21,21,21,21,21
82,21,21,17,18,21,21,21,21,21,21,17,13,13,13,13,13,13,13,13,13,13,18,21,21
82,21,21,16,19,21,21,21,21,21,21,11,25,26,08,25,26,15,09,10,08,08,14,18,21
82,21,21,21,21,21,21,21,21,21,21,11,08,15,09,09,09,19,21,11,08,08,08,22,21
82,21,21,21,21,21,21,21,21,21,21,11,08,14,18,21,21,21,21,11,08,08,08,22,21
82,21,21,21,21,21,17,13,18,17,13,12,25,01,22,21,21,21,21,16,09,09,09,19,21
82,21,21,21,21,21,11,08,22,11,08,02,25,07,14,13,18,21,21,21,17,13,13,18,21
82,17,13,13,13,13,12,08,14,12,00,15,09,10,07,02,14,13,18,21,11,08,08,22,21
82,11,15,09,09,09,10,25,07,00,08,22,21,16,10,04,08,08,22,21,11,08,08,22,21
82,11,22,21,21,21,16,10,07,00,00,14,13,13,12,08,15,09,19,21,16,09,09,19,21
82,11,22,21,21,21,21,11,28,27,04,20,01,06,08,15,19,21,21,21,17,13,13,13,18
82,11,22,21,21,21,21,16,09,10,08,07,00,00,03,14,13,13,13,13,12,20,01,02,22
82,11,22,21,21,21,21,21,21,11,08,00,00,00,04,08,08,08,08,08,08,07,00,03,22
82,11,22,21,21,21,21,21,21,16,09,09,09,09,09,09,10,15,09,09,10,06,05,04,22
82,12,14,13,18,21,21,21,21,21,21,21,21,21,21,21,16,19,21,21,16,09,09,09,19
82,03,07,00,22,21,21,21,21,21,21,21,21,21,21,21,21,21,21,21,21,21,21,21,21
82,03,07,00,22,21,21,21,21,21,21,21,21,21,21,21,21,21,21,21,21,21,21,21,21
82,04,06,00,22,21,21,21,21,21,21,21,21,21,21,21,21,21,21,21,21,21,21,21,21
82,09,09,09,19,21,21,21,21,21,21,21,21,21,21,21,21,21,21,21,21,21,21,21,21
82,21,21,21,21,21,21,21,21,21,21,21,21,21,21,21,21,21,21,21,21,21,21,21,21
